DateTimeBase	KEYWORD1
setRaw	KEYWORD2
getRaw	KEYWORD2
getRawNoSync	KEYWORD2
set	KEYWORD2

DateTimeRawBase	KEYWORD1
getDateTimeStruct	KEYWORD2
getDateStruct	KEYWORD2
getTimeStruct	KEYWORD2
getDate	KEYWORD2
setDate	KEYWORD2
setTime	KEYWORD2
setHours	KEYWORD2
setHours12	KEYWORD2
setHours24	KEYWORD2
addHours	KEYWORD2
getHours	KEYWORD2
getHours12	KEYWORD2
getHours24	KEYWORD2
isAM	KEYWORD2
setMinutes	KEYWORD2
addMinutes	KEYWORD2
getMinutes	KEYWORD2
setSeconds	KEYWORD2
addSeconds	KEYWORD2
getSeconds	KEYWORD2
setMilliseconds	KEYWORD2
addMilliseconds	KEYWORD2
getMilliseconds	KEYWORD2
setMicroseconds	KEYWORD2
addMicroseconds	KEYWORD2
getMicroseconds	KEYWORD2
setYear	KEYWORD2
addYears	KEYWORD2
getYear	KEYWORD2
isCurrentYearLeap	KEYWORD2
setMonth	KEYWORD2
addMonths	KEYWORD2
getMonth	KEYWORD2
setDay	KEYWORD2
addDays	KEYWORD2
getDay	KEYWORD2
getDayOfWeek	KEYWORD2
getWeekOfYear	KEYWORD2
getWeekOfMonth	KEYWORD2
getWeekDayOfMonth	KEYWORD2
setDayOfYear	KEYWORD2
getDayOfYear	KEYWORD2
setDaysFromEpoch	KEYWORD2
getDaysFromEpoch	KEYWORD2
setMicrosecondsOfDay	KEYWORD2
getMicrosecondsOfDay	KEYWORD2
getUnix	KEYWORD2
fromUnix	KEYWORD2
getOADate	KEYWORD2
fromOADate	KEYWORD2
get_time_t	KEYWORD2
from_time_t	KEYWORD2
get_tm	KEYWORD2
from_tm	KEYWORD2
toArray	KEYWORD2
toString	KEYWORD2
toISO8601Array	KEYWORD2
toISO8601String	KEYWORD2
printTo	KEYWORD2
parse	KEYWORD2

MaxValue	LITERAL1
MinValue	LITERAL1
Zero	LITERAL1
UnixBase	LITERAL1
OABase	LITERAL1

DateTime	KEYWORD1

DateTimeSysSync	KEYWORD1
getTimeFromLastSync	KEYWORD2
getRawSyncTime	KEYWORD2

DateTimeTZBase	KEYWORD1
getTimeZone	KEYWORD2
getTimeZoneOffset	KEYWORD2
getTimeZoneOffsetMinutes	KEYWORD2
setTimeZone	KEYWORD2
getDST	KEYWORD2
getCurrentDSTOffset	KEYWORD2
getCurrentDSTOffsetMinutes	KEYWORD2
getDSTOffset	KEYWORD2
getDSTOffsetMinutes	KEYWORD2
setDST	KEYWORD2
isDST	KEYWORD2
getUTC	KEYWORD2
setUTC	KEYWORD2
getNextTransitionDate	KEYWORD2

DateTimeTZ	KEYWORD1

DateTimeTZSysSync	KEYWORD1
recalcDST	KEYWORD2
getDateTimeEnh	KEYWORD2
isOverNextTrans	KEYWORD2

MICROSECOND	LITERAL1
MILLISECOND	LITERAL1
SECOND	LITERAL1
MINUTE	LITERAL1
HOUR	LITERAL1
DAY	LITERAL1
MICROS_PER_YEAR	LITERAL1
MICROS_PER_LEAP_YEAR	LITERAL1
MAX_YEAR	LITERAL1
MIN_YEAR	LITERAL1
MAX_DAYS	LITERAL1
MIN_DAYS	LITERAL1

WeekOfMonth	KEYWORD1
First	LITERAL1
Second	LITERAL1
Third	LITERAL1
Fourth	LITERAL1
Last	LITERAL1
Fifth	LITERAL1

DayOfWeek	KEYWORD1
getName	KEYWORD2
isValid	KEYWORD2
Unknown	LITERAL1
Sunday	LITERAL1
Monday	LITERAL1
Tuesday	LITERAL1
Wednesday	LITERAL1
Thursday	LITERAL1
Friday	LITERAL1
Saturday	LITERAL1

Month	KEYWORD1
getName	KEYWORD2
isValid	KEYWORD2
getMonthLength	KEYWORD2
Unknown	LITERAL1
January	LITERAL1
February	LITERAL1
March	LITERAL1
April	LITERAL1
May	LITERAL1
June	LITERAL1
July	LITERAL1
August	LITERAL1
September	LITERAL1
October	LITERAL1
November	LITERAL1
December	LITERAL1

DateTime_DST_tuple	KEYWORD1
value	KEYWORD2
isDST	KEYWORD2

hour_t	KEYWORD1
isAM	KEYWORD2
isPM	KEYWORD2
is24	KEYWORD2
is12	KEYWORD2
setHours12	KEYWORD2
setHours24	KEYWORD2
getHours	KEYWORD2
convertTo24	KEYWORD2
convertTo12	KEYWORD2

date_time_s	KEYWORD1
year	KEYWORD2
month	KEYWORD2
day	KEYWORD2
hours	KEYWORD2
minutes	KEYWORD2
seconds	KEYWORD2
milliseconds	KEYWORD2
microseconds	KEYWORD2
dayOfWeek	KEYWORD2

date_s	KEYWORD1
time_s	KEYWORD1

time_span_s	KEYWORD1
days	KEYWORD2
hours	KEYWORD2
minutes	KEYWORD2
seconds	KEYWORD2
milliseconds	KEYWORD2
microseconds	KEYWORD2

TimeSpan	KEYWORD1
getTimeSpanStruct	KEYWORD2
set	KEYWORD2
setDays	KEYWORD2
addDays	KEYWORD2
getDays	KEYWORD2
setHours	KEYWORD2
addHours	KEYWORD2
getHours	KEYWORD2
setMinutes	KEYWORD2
addMinutes	KEYWORD2
getMinutes	KEYWORD2
setSeconds	KEYWORD2
addSeconds	KEYWORD2
getSeconds	KEYWORD2
setMilliseconds	KEYWORD2
addMilliseconds	KEYWORD2
getMilliseconds	KEYWORD2
setMicroseconds	KEYWORD2
addMicroseconds	KEYWORD2
getMicroseconds	KEYWORD2
getDuration	KEYWORD2
isNegative	KEYWORD2
setRaw	KEYWORD2
getRaw	KEYWORD2
toArray	KEYWORD2
toString	KEYWORD2

TimeZone	KEYWORD1
setTimeZone	KEYWORD2
fromTotalMinutesOffset	KEYWORD2
getTimeZoneHours	KEYWORD2
getTimeZoneMinutes	KEYWORD2
getTimeZone	KEYWORD2
getTimeZoneOffset	KEYWORD2
getTimeZoneOffsetTotalMinutes	KEYWORD2

DSTTransitionRuleType	KEYWORD1
DSTTRT_Fixed	LITERAL1
DSTTRT_Date	LITERAL1
DSTTRT_Floating	LITERAL1
DSTTRT_NoDST	LITERAL1

DSTTransitionRule	KEYWORD1
Fixed	KEYWORD2
Date	KEYWORD2
Floating	KEYWORD2
setFixed	KEYWORD2
setDate	KEYWORD2
setFloating	KEYWORD2
getType	KEYWORD2
noDST	KEYWORD2
setTransitionTime	KEYWORD2
getTransitionTime	KEYWORD2
setDaysOffset	KEYWORD2
getDaysOffset	KEYWORD2
getDayOfYear	KEYWORD2
getMonth	KEYWORD2
getDayOfMonth	KEYWORD2
getDayOfWeek	KEYWORD2
getWeekOfMonth	KEYWORD2
getDayOfYearOfTransition	KEYWORD2
getDateOfTransition	KEYWORD2
NoDST	LITERAL1

DSTAdjustment	KEYWORD1
fromTotalMinutesOffset	KEYWORD2
DaylightTransitionStart	KEYWORD2
DaylightTransitionEnd	KEYWORD2
noDST	KEYWORD2
setDSTOffset	KEYWORD2
setDSTOffset	KEYWORD2
getDSTOffset	KEYWORD2
getDSTOffsetHours	KEYWORD2
getDSTOffsetMinutes	KEYWORD2
getDSTOffsetTotalMinutes	KEYWORD2
setDST	KEYWORD2
isDST	KEYWORD2
checkDSTRegion	KEYWORD2
getNextTransitionDate	KEYWORD2
NoDST	LITERAL1
NorthAmerica	LITERAL1
Cuba	LITERAL1
Mexico	LITERAL1
WesternEurope	LITERAL1
CentralEurope	LITERAL1
EasternEurope	LITERAL1
Greenland	LITERAL1
Moldova	LITERAL1
Israel	LITERAL1
Lebanon	LITERAL1
Palestine	LITERAL1
Syria	LITERAL1
Jordan	LITERAL1
Chile	LITERAL1
Paraguay	LITERAL1
Australia	LITERAL1
Australia_Lord_Howe_Island	LITERAL1
NewZeland	LITERAL1

TIME_ZONE_INFO_TZ_NAME_SIZE	LITERAL1
TIME_ZONE_INFO_TZ_ABR_NAME_SIZE	LITERAL1

TimeZoneInfo	KEYWORD1
fromPOSIX	KEYWORD2
toPOSIX	KEYWORD2
timeZone	KEYWORD2
DST	KEYWORD2
standardName	KEYWORD2
daylightName	KEYWORD2
keyName	KEYWORD2
standardABR	KEYWORD2
daylightABR	KEYWORD2
Empty	LITERAL1

TimeZones	KEYWORD1
BIT	LITERAL1
NUT	LITERAL1
SST	LITERAL1
CKT	LITERAL1
HAST	LITERAL1
TAHT	LITERAL1
MART	LITERAL1
MIT	LITERAL1
AKST	LITERAL1
GAMT	LITERAL1
GIT	LITERAL1
CIST	LITERAL1
PST	LITERAL1
MST	LITERAL1
CST	LITERAL1
EAST	LITERAL1
GALT	LITERAL1
AcT	LITERAL1
COT	LITERAL1
CuST	LITERAL1
EcT	LITERAL1
EST	LITERAL1
PET	LITERAL1
AMT	LITERAL1
AtST	LITERAL1
BOT	LITERAL1
CLT	LITERAL1
ECT	LITERAL1
FKT	LITERAL1
GYT	LITERAL1
PYT	LITERAL1
VET	LITERAL1
NST	LITERAL1
NT	LITERAL1
ART	LITERAL1
BRT	LITERAL1
GFT	LITERAL1
PMST	LITERAL1
ROTT	LITERAL1
SRT	LITERAL1
UYT	LITERAL1
FNT	LITERAL1
SGST	LITERAL1
AZOT	LITERAL1
CVT	LITERAL1
EGT	LITERAL1
GMT	LITERAL1
UTC	LITERAL1
WET	LITERAL1
CET	LITERAL1
DFT	LITERAL1
IrST	LITERAL1
MET	LITERAL1
WAT	LITERAL1
CAT	LITERAL1
EET	LITERAL1
HAEC	LITERAL1
IsST	LITERAL1
SAST	LITERAL1
USZ1	LITERAL1
AST	LITERAL1
EAT	LITERAL1
FET	LITERAL1
IOT	LITERAL1
MSK	LITERAL1
SYOT	LITERAL1
TRT	LITERAL1
IRST	LITERAL1
ArMT	LITERAL1
AZT	LITERAL1
GET	LITERAL1
GST	LITERAL1
MUT	LITERAL1
RET	LITERAL1
SAMT	LITERAL1
SCT	LITERAL1
VOLT	LITERAL1
AF	LITERAL1
HMT	LITERAL1
MAWT	LITERAL1
MVT	LITERAL1
ORAT	LITERAL1
PKT	LITERAL1
TFT	LITERAL1
TJT	LITERAL1
TMT	LITERAL1
UZT	LITERAL1
YEKT	LITERAL1
InST	LITERAL1
SLST	LITERAL1
NPT	LITERAL1
BIOT	LITERAL1
BST	LITERAL1
BTT	LITERAL1
KGT	LITERAL1
OMST	LITERAL1
VOST	LITERAL1
ACT	LITERAL1
CCT	LITERAL1
MMT	LITERAL1
CXT	LITERAL1
DAVT	LITERAL1
HOVT	LITERAL1
ICT	LITERAL1
KRAT	LITERAL1
THA	LITERAL1
WIT	LITERAL1
AWST	LITERAL1
BDT	LITERAL1
CHOT	LITERAL1
CIT	LITERAL1
CT	LITERAL1
HKT	LITERAL1
HOVST	LITERAL1
IRKT	LITERAL1
MYT	LITERAL1
PHT	LITERAL1
SGT	LITERAL1
ULAT	LITERAL1
WST	LITERAL1
CWST	LITERAL1
EIT	LITERAL1
JST	LITERAL1
KST	LITERAL1
TLT	LITERAL1
ULAST	LITERAL1
YAKT	LITERAL1
ACST	LITERAL1
AEST	LITERAL1
CHST	LITERAL1
CHUT	LITERAL1
DDUT	LITERAL1
PGT	LITERAL1
VLAT	LITERAL1
LHST	LITERAL1
BVST	LITERAL1
KOST	LITERAL1
MIST	LITERAL1
NCT	LITERAL1
NFT	LITERAL1
PONT	LITERAL1
SAKT	LITERAL1
SBT	LITERAL1
SRET	LITERAL1
VUT	LITERAL1
FJT	LITERAL1
GILT	LITERAL1
MAGT	LITERAL1
MHT	LITERAL1
NZST	LITERAL1
PETT	LITERAL1
TVT	LITERAL1
WAKT	LITERAL1
CHAST	LITERAL1
PHOT	LITERAL1
TKT	LITERAL1
TOT	LITERAL1
LINT	LITERAL1

Pacific_Midway	LITERAL1
Pacific_Niue	LITERAL1
Pacific_Pago_Pago	LITERAL1
America_Adak	LITERAL1
Pacific_Honolulu	LITERAL1
Pacific_Rarotonga	LITERAL1
Pacific_Tahiti	LITERAL1
Pacific_Marquesas	LITERAL1
America_Anchorage	LITERAL1
America_Juneau	LITERAL1
America_Metlakatla	LITERAL1
America_Nome	LITERAL1
America_Sitka	LITERAL1
America_Yakutat	LITERAL1
Pacific_Gambier	LITERAL1
America_Los_Angeles	LITERAL1
America_Tijuana	LITERAL1
America_Vancouver	LITERAL1
Pacific_Pitcairn	LITERAL1
America_Boise	LITERAL1
America_Cambridge_Bay	LITERAL1
America_Chihuahua	LITERAL1
America_Creston	LITERAL1
America_Dawson	LITERAL1
America_Dawson_Creek	LITERAL1
America_Denver	LITERAL1
America_Edmonton	LITERAL1
America_Fort_Nelson	LITERAL1
America_Hermosillo	LITERAL1
America_Inuvik	LITERAL1
America_Mazatlan	LITERAL1
America_Ojinaga	LITERAL1
America_Phoenix	LITERAL1
America_Whitehorse	LITERAL1
America_Yellowknife	LITERAL1
America_Bahia_Banderas	LITERAL1
America_Belize	LITERAL1
America_Chicago	LITERAL1
America_Costa_Rica	LITERAL1
America_El_Salvador	LITERAL1
America_Guatemala	LITERAL1
America_Indiana_Knox	LITERAL1
America_Indiana_Tell_City	LITERAL1
America_Managua	LITERAL1
America_Matamoros	LITERAL1
America_Menominee	LITERAL1
America_Merida	LITERAL1
America_Mexico_City	LITERAL1
America_Monterrey	LITERAL1
America_North_Dakota_Beulah	LITERAL1
America_North_Dakota_Center	LITERAL1
America_North_Dakota_New_Salem	LITERAL1
America_Rainy_River	LITERAL1
America_Rankin_Inlet	LITERAL1
America_Regina	LITERAL1
America_Resolute	LITERAL1
America_Swift_Current	LITERAL1
America_Tegucigalpa	LITERAL1
America_Winnipeg	LITERAL1
Pacific_Easter	LITERAL1
Pacific_Galapagos	LITERAL1
America_Atikokan	LITERAL1
America_Bogota	LITERAL1
America_Cancun	LITERAL1
America_Cayman	LITERAL1
America_Detroit	LITERAL1
America_Eirunepe	LITERAL1
America_Grand_Turk	LITERAL1
America_Guayaquil	LITERAL1
America_Havana	LITERAL1
America_Indiana_Indianap	LITERAL1olis
America_Indiana_Marengo	LITERAL1
America_Indiana_Petersburg	LITERAL1
America_Indiana_Vevay	LITERAL1
America_Indiana_Vincennes	LITERAL1
America_Indiana_Winamac	LITERAL1
America_Iqaluit	LITERAL1
America_Jamaica	LITERAL1
America_Kentucky_Louisville	LITERAL1
America_Kentucky_Monticello	LITERAL1
America_Lima	LITERAL1
America_Nassau	LITERAL1
America_New_York	LITERAL1
America_Nipigon	LITERAL1
America_Panama	LITERAL1
America_Pangnirtung	LITERAL1
America_Port_au_Prince	LITERAL1
America_Rio_Branco	LITERAL1
America_Thunder_Bay	LITERAL1
America_Toronto	LITERAL1
America_AnguillaSandy_Hill	LITERAL1
America_Antigua	LITERAL1
America_Aruba	LITERAL1
America_Asuncion	LITERAL1
America_Barbados	LITERAL1
America_Blanc_Sablon	LITERAL1
America_Boa_Vista	LITERAL1
America_Campo_Grande	LITERAL1
America_Caracas	LITERAL1
America_Cuiaba	LITERAL1
America_Curacao	LITERAL1
America_Dominica	LITERAL1
America_Glace_Bay	LITERAL1
America_Goose_Bay	LITERAL1
America_Grenada	LITERAL1
America_Guadeloupe	LITERAL1
America_Guyana	LITERAL1
America_Halifax	LITERAL1
America_Kralendijk	LITERAL1
America_La_Paz	LITERAL1
America_Lower_Princes	LITERAL1
America_Manaus	LITERAL1
America_Marigot	LITERAL1
America_Martinique	LITERAL1
America_Moncton	LITERAL1
America_Montserrat	LITERAL1
America_Porto_Velho	LITERAL1
America_Port_of_Spain	LITERAL1
America_Puerto_Rico	LITERAL1
America_Santiago	LITERAL1
America_Santo_Domingo	LITERAL1
America_St_Barthelemy	LITERAL1
America_St_Kitts	LITERAL1
America_St_Lucia	LITERAL1
America_St_Thomas	LITERAL1
America_St_Vincent	LITERAL1
America_Thule	LITERAL1
America_Tortola	LITERAL1
Atlantic_Bermuda	LITERAL1
America_St_Johns	LITERAL1
America_Araguaina	LITERAL1
America_Argentina_Buenos_Aires	LITERAL1
America_Argentina_Catamarca	LITERAL1
America_Argentina_Cordoba	LITERAL1
America_Argentina_Jujuy	LITERAL1
America_Argentina_La_Rioja	LITERAL1
America_Argentina_Mendoza	LITERAL1
America_Argentina_Rio_Gallegos	LITERAL1
America_Argentina_Salta	LITERAL1
America_Argentina_San_Juan	LITERAL1
America_Argentina_San_Luis	LITERAL1
America_Argentina_Tucuman	LITERAL1
America_Argentina_Ushuaia	LITERAL1
America_Bahia	LITERAL1
America_Belem	LITERAL1
America_Cayenne	LITERAL1
America_Fortaleza	LITERAL1
America_Godthab	LITERAL1
America_Maceio	LITERAL1
America_Miquelon	LITERAL1
America_Montevideo	LITERAL1
America_Paramaribo	LITERAL1
America_Punta_Arenas	LITERAL1
America_Recife	LITERAL1
America_Santarem	LITERAL1
America_Sao_Paulo	LITERAL1
Antarctica_Palmer	LITERAL1
Antarctica_Rothera	LITERAL1
Atlantic_Stanley	LITERAL1
America_Noronha	LITERAL1
Atlantic_South_Georgia	LITERAL1
America_Scoresbysund	LITERAL1
Atlantic_Azores	LITERAL1
Atlantic_Cape_Verde	LITERAL1
Africa_Abidjan	LITERAL1
Africa_Accra	LITERAL1
Africa_Bamako	LITERAL1
Africa_Banjul	LITERAL1
Africa_Bissau	LITERAL1
Africa_Casablanca	LITERAL1
Africa_Conakry	LITERAL1
Africa_Dakar	LITERAL1
Africa_El_Aaiun	LITERAL1
Africa_Freetown	LITERAL1
Africa_Lome	LITERAL1
Africa_Monrovia	LITERAL1
Africa_Nouakchott	LITERAL1
Africa_Ouagadougou	LITERAL1
Africa_Sao_Tome	LITERAL1
America_Danmarkshavn	LITERAL1
Antarctica_Troll	LITERAL1
Atlantic_Canary	LITERAL1
Atlantic_Faroe	LITERAL1
Atlantic_Madeira	LITERAL1
Atlantic_Reykjavik	LITERAL1
Atlantic_St_Helena	LITERAL1
Europe_Dublin	LITERAL1
Europe_Guernsey	LITERAL1
Europe_Isle_of_Man	LITERAL1
Europe_Jersey	LITERAL1
Europe_Lisbon	LITERAL1
Europe_London	LITERAL1
Africa_Algiers	LITERAL1
Africa_Bangui	LITERAL1
Africa_Brazzaville	LITERAL1
Africa_Ceuta	LITERAL1
Africa_Douala	LITERAL1
Africa_Kinshasa	LITERAL1
Africa_Lagos	LITERAL1
Africa_Libreville	LITERAL1
Africa_Luanda	LITERAL1
Africa_Malabo	LITERAL1
Africa_Ndjamena	LITERAL1
Africa_Niamey	LITERAL1
Africa_Porto_Novo	LITERAL1
Africa_Tunis	LITERAL1
Africa_Windhoek	LITERAL1
Arctic_Longyearbyen	LITERAL1
Europe_Amsterdam	LITERAL1
Europe_Andorra	LITERAL1
Europe_Belgrade	LITERAL1	LITERAL1
Europe_Berlin	LITERAL1
Europe_Bratislava	LITERAL1
Europe_Brussels	LITERAL1
Europe_Budapest	LITERAL1
Europe_Copenhagen	LITERAL1
Europe_Gibraltar	LITERAL1
Europe_Ljubljana	LITERAL1
Europe_Luxembourg	LITERAL1
Europe_Madrid	LITERAL1
Europe_Malta	LITERAL1
Europe_Monaco	LITERAL1
Europe_Oslo	LITERAL1
Europe_Paris	LITERAL1
Europe_Podgorica	LITERAL1
Europe_Prague	LITERAL1
Europe_Rome	LITERAL1
Europe_San_Marino	LITERAL1
Europe_Sarajevo	LITERAL1
Europe_Skopje	LITERAL1
Europe_Stockholm	LITERAL1
Europe_Tirane	LITERAL1
Europe_Vaduz	LITERAL1
Europe_Vatican	LITERAL1
Europe_Vienna	LITERAL1
Europe_Warsaw	LITERAL1
Europe_Zagreb	LITERAL1
Europe_Zurich	LITERAL1
Africa_Blantyre	LITERAL1
Africa_Bujumbura	LITERAL1
Africa_Cairo	LITERAL1
Africa_Gaborone	LITERAL1
Africa_Harare	LITERAL1
Africa_Johannesburg	LITERAL1
Africa_Juba	LITERAL1
Africa_Khartoum	LITERAL1
Africa_Kigali	LITERAL1
Africa_Lubumbashi	LITERAL1
Africa_Lusaka	LITERAL1
Africa_Maputo	LITERAL1
Africa_Maseru	LITERAL1
Africa_Mbabane	LITERAL1
Africa_Tripoli	LITERAL1
Asia_Amman	LITERAL1
Asia_Beirut	LITERAL1
Asia_Damascus	LITERAL1
Asia_Famagusta	LITERAL1
Asia_Gaza	LITERAL1
Asia_Hebron	LITERAL1
Asia_Jerusalem	LITERAL1
Asia_Nicosia	LITERAL1
Europe_Athens	LITERAL1
Europe_Bucharest	LITERAL1
Europe_Chisinau	LITERAL1
Europe_Helsinki	LITERAL1
Europe_Kaliningrad	LITERAL1
Europe_Kiev	LITERAL1
Europe_Mariehamn	LITERAL1
Europe_Riga	LITERAL1
Europe_Sofia	LITERAL1
Europe_Tallinn	LITERAL1
Europe_Uzhgorod	LITERAL1
Europe_Vilnius	LITERAL1
Europe_Zaporozhye	LITERAL1
Africa_Addis_Ababa	LITERAL1
Africa_Asmara	LITERAL1
Africa_Dar_es_Salaam	LITERAL1
Africa_Djibouti	LITERAL1
Africa_Kampala	LITERAL1
Africa_Mogadishu	LITERAL1
Africa_Nairobi	LITERAL1
Antarctica_Syowa	LITERAL1
Asia_Aden	LITERAL1
Asia_Baghdad	LITERAL1
Asia_Bahrain	LITERAL1
Asia_Kuwait	LITERAL1
Asia_Qatar	LITERAL1
Asia_Riyadh	LITERAL1
Europe_Istanbul	LITERAL1
Europe_Kirov	LITERAL1
Europe_Minsk	LITERAL1
Europe_Moscow	LITERAL1
Europe_Simferopol	LITERAL1
Europe_Volgograd	LITERAL1
Indian_Antananarivo	LITERAL1
Indian_Comoro	LITERAL1
Indian_Mayotte	LITERAL1
Asia_Tehran	LITERAL1
Asia_Baku	LITERAL1
Asia_Dubai	LITERAL1
Asia_Muscat	LITERAL1
Asia_Tbilisi	LITERAL1
Asia_Yerevan	LITERAL1
Europe_Astrakhan	LITERAL1
Europe_Samara	LITERAL1
Europe_Saratov	LITERAL1
Europe_Ulyanovsk	LITERAL1
Indian_Mahe	LITERAL1
Indian_Mauritius	LITERAL1
Indian_Reunion	LITERAL1
Asia_Kabul	LITERAL1
Antarctica_Mawson	LITERAL1
Asia_Aqtau	LITERAL1
Asia_Aqtobe	LITERAL1
Asia_Ashgabat	LITERAL1
Asia_Atyrau	LITERAL1
Asia_Dushanbe	LITERAL1
Asia_Karachi	LITERAL1
Asia_Oral	LITERAL1
Asia_Qyzylorda	LITERAL1
Asia_Samarkand	LITERAL1
Asia_Tashkent	LITERAL1
Asia_Yekaterinburg	LITERAL1
Indian_Kerguelen	LITERAL1
Indian_Maldives	LITERAL1
Asia_Colombo	LITERAL1
Asia_Kolkata	LITERAL1
Asia_Kathmandu	LITERAL1
Antarctica_Vostok	LITERAL1
Asia_Almaty	LITERAL1
Asia_Bishkek	LITERAL1
Asia_Dhaka	LITERAL1
Asia_Omsk	LITERAL1
Asia_Qostanay	LITERAL1
Asia_Thimphu	LITERAL1
Asia_Urumqi	LITERAL1
Indian_Chagos	LITERAL1
Asia_Yangon	LITERAL1
Indian_Cocos	LITERAL1
Antarctica_Davis	LITERAL1
Asia_Bangkok	LITERAL1
Asia_Barnaul	LITERAL1
Asia_Hovd	LITERAL1
Asia_Ho_Chi_Minh	LITERAL1
Asia_Jakarta	LITERAL1
Asia_Krasnoyarsk	LITERAL1
Asia_Novokuznetsk	LITERAL1
Asia_Novosibirsk	LITERAL1
Asia_Phnom_Penh	LITERAL1
Asia_Pontianak	LITERAL1
Asia_Tomsk	LITERAL1
Asia_Vientiane	LITERAL1
Indian_Christmas	LITERAL1
Asia_Brunei	LITERAL1
Asia_Choibalsan	LITERAL1
Asia_Hong_Kong	LITERAL1
Asia_Irkutsk	LITERAL1
Asia_Kuala_Lumpur	LITERAL1
Asia_Kuching	LITERAL1
Asia_Macau	LITERAL1
Asia_Makassar	LITERAL1
Asia_Manila	LITERAL1
Asia_Shanghai	LITERAL1
Asia_Singapore	LITERAL1
Asia_Taipei	LITERAL1
Asia_Ulaanbaatar	LITERAL1
Australia_Perth	LITERAL1
Australia_Eucla	LITERAL1
Asia_Chita	LITERAL1
Asia_Dili	LITERAL1
Asia_Jayapura	LITERAL1
Asia_Khandyga	LITERAL1
Asia_Pyongyang	LITERAL1
Asia_Seoul	LITERAL1
Asia_Tokyo	LITERAL1
Asia_Yakutsk	LITERAL1
Pacific_Palau	LITERAL1
Australia_Adelaide	LITERAL1
Australia_Broken_Hill	LITERAL1
Australia_Darwin	LITERAL1
Antarctica_DumontDUrville	LITERAL1
Antarctica_Macquarie	LITERAL1
Asia_Ust_Nera	LITERAL1
Asia_Vladivostok	LITERAL1
Australia_Brisbane	LITERAL1
Australia_Currie	LITERAL1
Australia_Hobart	LITERAL1
Australia_Lindeman	LITERAL1
Australia_Melbourne	LITERAL1
Australia_Sydney	LITERAL1
Pacific_Chuuk	LITERAL1
Pacific_GuamVillage	LITERAL1
Pacific_Port_Moresby	LITERAL1
Pacific_Saipan	LITERAL1
Australia_Lord_Howe	LITERAL1
Antarctica_Casey	LITERAL1
Asia_Magadan	LITERAL1
Asia_Sakhalin	LITERAL1
Asia_Srednekolymsk	LITERAL1
Pacific_Bougainville	LITERAL1
Pacific_Efate	LITERAL1
Pacific_Guadalcanal	LITERAL1
Pacific_Kosrae	LITERAL1
Pacific_Norfolk	LITERAL1
Pacific_Noumea	LITERAL1
Pacific_Pohnpei	LITERAL1
Antarctica_McMurdo	LITERAL1
Asia_Anadyr	LITERAL1
Asia_Kamchatka	LITERAL1
Pacific_Auckland	LITERAL1
Pacific_Fiji	LITERAL1
Pacific_Funafuti	LITERAL1
Pacific_Kwajalein	LITERAL1
Pacific_Majuro	LITERAL1
Pacific_Nauru	LITERAL1
Pacific_Tarawa	LITERAL1
Pacific_Wake	LITERAL1
Pacific_Wallis	LITERAL1
Pacific_Chatham	LITERAL1
Pacific_Apia	LITERAL1
Pacific_Enderbury	LITERAL1
Pacific_Fakaofo	LITERAL1
Pacific_Tongatapu	LITERAL1
Pacific_Kiritimati	LITERAL1